R 1200 800

NO cape.xpm
SO bluestone.xpm
WE purplestone.xpm
EA redbrick.xpm

S barrel.xpm

C 213,250,255
F 216,175,120




        1111111111111111111111111
        11000000000110000000000001
        1011000001110000000000001
        1001000000000000000000001
 11111111011000001110000000000001
100000000011000001111111111111111
 1111111111111011100000010001
11110111111111010101010010001
11000000110101010100000010001
100E000200020022000000000001
1000000000202000101010010001
1100000111012101111101111000111
11110111 1110101 101111010001
11111111 1111111 111111111111