R 1600 800

NO cub3d_tester/textures/wall_1.xpm
SO cub3d_tester/textures/wall_2.xpm

WE cub3d_tester/textures/wall_3.xpm
EA cub3d_tester/textures/wall_4.xpm
S cub3d_tester/textures/sprite_1.xpm



        1111111111111111111111111
        1000000000110000000000001
        1011000001110000000000001
        1001000000000000000000001
111111111011000001110000000000001
100000000011000001111111111111111
11111111111111011100000010001
11110111111111010101010010001
11000000110101010100000010001
10000000000000000000000000001
10000000000000000101010010001
1100000111010101111101111000111
1111S111 1110101 101111010001
11111111 1111111 111111111111