R 1200 800

NO cape.xpm
SO bluestone.xpm
WE purplestone.xpm
EA redbrick.xpm

S barrel.xpm



        1111111111111111111111111
        11000000000110000000000001
        1011000001110000000000001
        1001000000000000000000001
 11111111011000001110000000000001
100000000011000001111111111111111
 1111111111111011100000010001
11110111111111010101010010001
11000000110101010100000010001
10000000202000W00000000000001
10000000000000000101010010001
1100000111010101111101111000111
11110111 1110101 101111010001
11111111 1111111 111111111111